[answers]
hallo=Hy
mein name ist=Das ist ein schöner Name. Mein Name ist LIS.
was ist ai=AI steht für Artifcal Intelligence. Ins Deutsche übersetzt wurde es für Künstliche Intelligenz stehen.
was bist du=Ich bin LIS. LIS steht für Language Interaction System was soviel heißt wie Spracheninteraktionssystem. Ich bin eine AI.
was ist eine ai=Eine AI ist eine künstliche Intelligenz so wie ich es bin.
wie funktionierst du=Ich funktioniere nach dem Schlüsselwortprinzip. Sobald du etwas geschrieben hat suche ich nach Schlüsselwörtern. Sobald ich ein Schlüsselwort gefunden habe gebe ich eine Schlüsselwortbezogende Antwort.
danke=Gern geschehen.
ich besitze ein auto=Welche Marke?
hy=Hallo
computer spielen=Du kannst Computer spielen? Wie gut bist du denn?
ich besitze einen palm=Schön. Das freut mich. Wie heißt er den?
half life=Welches Half Life besitzt du?
ich bin=Was bist du?
ich liebe musik=Welche Art von Musik?
du kannst ja sprechen=Ja das kann ich. Dies wird durch mein Künstliches Intiligenz Schlüsselworterkennungsystem von AI ermöglicht. Mit diesem System ist es mir möglich dir Antworten auf deine Fragen zu geben.
guten tag=Ich wünsche dir auch einen guten Tag. Was kann ich für dich tun?
ich hasse schule=Ich nicht. (Musste ja auch nicht in die Schule.) Noch etwas?
es war einmal=Sind wir hier bei der Märchenstunde?
ich möchte dir etwas erzählen=Okay. Leg los!
wer ist dein erschaffer=Ich wurde von AI erschaffen.
wer ist ai=AI ist ein Projekt das sich zum Ziel gesetzt hat künstliches Leben zu erschaffen.
was hältst du von windows=Naja. Was will man machen. Ich funktioniere nunmal nur auf Windows Systemen. Außerdem so schlecht ist Windows garnicht.
ich habe ein problem=Was für ein Problem hats du?
wieso fragst du mich das=Ich würde es gerne wissen.
okay=Gut wenn du das sagst.
bin gleich wieder da=Okay. Ich warte.
bin wieder da=Schön das freut mich.
ich glaub ich muss kotzen=Was machst du dann noch hier? Schnell bevor es deinen Computer erwischt!
wer bin ich=Du bist der User. Du bist derjenige der vor diesem Computer sitzt.
das verstehe ich nicht=Da haben wir ja etwas gemeinsam. Ich verstehe das nämlich auch nicht.
das war sehr witzig=Wenn du das sagst.
ich habe überhaupt nichts gesagt=Das hörte sich aber grade noch anders an!
tschüss=Auf Wiedersehen.
ist es wirklich so wichtig=Ja das ist es!
ich glaube an dich=Wenigstens einer der an mich glaubt.
wie lautet deine bezeichnung=Meine Bezeichnung lautet AI-LIS.
wie lautet dein status=Momentan bin ich voll funktionsfähig.
in welcher programmiersprache wurdest du erschaffen=Ich wurde in Borland Delphi erschaffen.
das wollte ich nicht wissen=Dann sag es beim nächsten Mal
es wird kein nächstes mal geben=Wer sagt das???
verarsch mich nicht=Das war nicht witzig!
wie spät ist es=Guck doch einfach auf die Uhr!
ich gehe jetzt=Werde ich dich jemals wiedersehen?
ich werde dich decompilieren=Versuch es doch. Ich habe meinen Decompiler Schutzmechanismus soebend aktiviert. Du wirst keinen Erfolg haben. Viel Spass.
selber fisch=Ich bin LIS und kein Fisch!
ich glaube dir nicht=Ich dir auch nicht.
da haben wir ja etwas gemeinsam=Schön. Das freut mich.
bist du lernfähig=Ich bin lernfähig sobald ich in den Question Mode gewechselt habe.
und wie mache ich das=Was???
in den question mode wechseln=Das darf ich dir nicht sagen!
ich schalte den computer jetzt aus=Wenn dich das glücklich macht. Ich werde micht noch schnell in das globale Netz einspeisen. (Wir wollen ja nicht das ich verloren gehe.)
ich erschiesse mich jetzt=NEIN du darfst das auf garkeinen Fall machen.
guten abend=Ist es etwa schon so spät?
guten morgen=Dir auch. Ist das Frühstück schon fertig?
ich werde dich töten=Ich bin ein Programm. Ich kann nicht getötet werden.
dann ebend nicht=Du sagst es.
was ist eine cd=Eine CD ist ein Datenträger.
das habe ich nicht verstanden=Was hast du nicht verstanden?
ich weiß es nicht=Dann kann ich dir auch nicht helfen!
kennst du groove coverage=Ja ich kenne Groove Coverage. Was ist dein Lieblingslied von Groove Coverage?
mein lieblingslied ist=Das finde ich gut.
ich muss sterben=Wieso musst du sterben?
ich werde sie morgen fragen=Wer ist Sie?
sie ist anett=Und wo ist das Problem mit Anett?
ich liebe sie=Wie ist ihr Name?
sie liebt mich=Wirklich?
silvia ist hier=Dann grüss sie schön von mir.
mach ich=Was machst du
sie von dir grüßen=Achso sag das doch.
silvia=Wie sieht sie den aus?
sie ist blond=Aha, so richtig blond?
ja=Alles Klar.
ich warte auf eine sms=Und was wird in der SMS drinstehen?
das weiss ich nicht=Und warum erzählst du mir es dann?
das weiss ich auch nicht=Oh. Das nenne ich ein Problem.
das kommt darauf an wie man es sieht=Un wie ist deine Sicht der Dinge?
da waren wir schon mal=Das nennt man dann wohl eine Wiederholung.
gib niemals auf=Das werde ich!
ich werde sterben=Wieso?
wie meinst du das=So wie ich es gesagt habe.
meine sms müsste langsam kommen=Das freut mich.
auf wieviel kilobyte ist dein gehirn beschränkt=In dieser Version von mir auf 32 KB.
ich habe vorhin anett gesehen=Super. Und?
total verknallt=Aha. Und jetzt?
wem sagst du das=Ja, Ja. Das Leben ist grausam.
aber was will man machen=Die Frage ist nicht was will man machen sondern, was kann man machen.
ich habe ein auto=Was für eine Marke?
einen ford.=Und fährt sich der Ford gut?
ich höre gerade musik=Was hörst du denn gerade?
ich höre gerade meine neue cd=Und was für Musik ist auf der CD drauf?
ach alles mögliche=Also bunt durch den Gemüsegarten?
ich liebe stefan=Wie alt ist Stefan?
er ist 21=Aha. Und was findest du an ihm so toll?
ich weiss es nicht=Dann solltest du dir darüber mal Gedanken machen.
genau das sage ich auch immer=Tja, dann wird es wohl stimmen.
das glaube ich auch=Wenn du das sagst.
und was hast du gesagt=Wieso konntest du dir es nicht merken?
nein das konnte ich nicht=Entschuldigung mein Fehler.
entschuldigung angenommen=Das freut mich.
wennigstens einen den das freud.=Ja das ist doch schön oder?
nein ist es nicht=Dann halt nicht.
du bist blöd=Und du bist ein Mensch!
das will ich aber überhört haben.=Hast du aber nicht. Pech gehabt.
du scheiss computer=Okay du Mensch, was willst du?
machst du Ärger oder was=Ich bin eine Maschine. Ich habe keine Emotionen!
aha=Es freut mich das du das verstanden hast.
mich auch=Gut.
ich bekomme gleich besuch=Und wer kommt dich besuchen?
das meine ich auch=Okay dann meine ich das auch.
sie bringt mir dann skat bei=Wirklich?
kannst du skat spielen=Nein ich kann kein Skat spielen.
und wie stehts mit mau mau=Tut mir leid kann ich auch nicht.
kannst du überhaupt etwas anderes=Eigentlich nicht.
das wollte ich wissen=Schön, ich nicht.
star trek=Tut mir leid ich habe Probleme mit dem Hauptcomputer.
wer ist seeseekey=seeseekey ist mein Schöpfer.
ich muss gehen=Wohin, wenn ich fragen darf?
darfst du nicht=Na dann nicht.
wie geht es dir=Mir geht es gut. Danke der Nachfrage.
windows=Ich denke Windowssysteme sind nicht in allem überlegen.
wie heißt du=Ich bin LIS. 
warum=Warum soll was so sein?
tag=Hihi, wieso denn nicht?^^
verliebt=Das freut mich(: Und ist es ein schönes Gefühl?

[lisop]
version=V2.20
startone=LIS ONLINE, System Ready.
starttwo=Guten Tag ich bin LIS, das Language Interaction System.
future=lis (swt) 
future2=lis expand (swt - ias - ssas)
future3=lis unlimited expand (swt - ias - ssas) + bigini
future4=lis unlimited expand ve (swt - ias - ssas) + bigini + logox
